20
20
wwwwwwwwwwwwwwwwwwww
w                  w
w                  w
w                  w
w          k       w
w          w       w
w                  w
w                  w
w                  w
w                  w
w                  w
w p                w
w                  w
w                  w
w                  w
w                  w
w                  w
w   k  c           w
wwwwwwww wwwwwwwwdww
w      www         w
wwwwwwwwwwwwwwwwwwww