20
20
wwwwwwwwwwwwwwwwwwww
w                  w
w           k      w
w sss sss sss sss  w
w s s s s s s s    w
w sss ss  s s s    w
w s   s s s s s ss w
w s   s s s s s  s w
w s   s s sss ssss w
w                  w
w p                w
www                w
w                  w
w                  w
w                  w
w                  w
w   k  c     s     w
wwwwwwwwswwwwwwwwdww
w      www         w
wwwwwwwwwwwwwwwwwwww