20
20
wwwwwwwwwwwwwwwwwwww
w                  w
w                  w
w   k              w
w   c              w
w p c      ssssksssw
wwwww www wwwssssssw
w   www      wwwwwww
w                  w
w www w   w w  w   w
w sks c   ww  w w  w
w www w   w   www  w
w w   w   ww  w w  w
w w   w   w w w w  w
w                  w
w                  w
wwwwwwwww wdwwwwwwww
wwwwwwwww wwwwwwwwww
wwwwwwwwwwwwwwwwwwww
wwwwwwwwwwwwwwwwwwww